+-+-+-+-+-+-+-+-+-+-+-+-+-+-+-+-+-+-+-+-+-+-+-+-+-+-+-+-+-+-+-+-+-+-+-+-+-+-+-+-+-+-+-+-+-+-+-+-+-+-+-+-+-+-+-+-+-+-+-+-+-+-+-+-+-+-+-+-+-+-+-+-+-+-+-+
    |   |   |               |   |   | |   |       |   |       |               | |       |     |       |     |   |   |     |     |   |           |     |
+ +-+ + +-+ + +-+-+-+-+ +-+ + + +-+ + + + +-+ +-+ + + + +-+-+ +-+-+-+-+-+-+-+ + + +-+-+ + + + + + +-+ + + + +-+ + + + +-+ + +-+ + + + +-+-+-+-+ + + +-+
| |   |     | |   |     |   | |   |   | |     |   | | | | |   |     |       | | | |   | | | |   |   | | | |       | |   |     | | | |       | | | |   |
+ + +-+-+ +-+ + +-+ +-+-+ +-+-+-+ + + + +-+-+ + +-+ + + + + +-+ +-+ + +-+-+ + + + + +-+ + +-+-+-+-+ + +-+ +-+-+-+-+ +-+ +-+-+ + +-+ +-+-+-+ + + + +-+ +
|   |     |   |       | | |   | |   | |   |   |   | |   |   |   | | | |   |       | |   | |   |     |   |   |     |   | |   | |       |   | |   | |   |
+-+ + +-+-+ +-+-+-+-+ + + +-+ + +-+ + +-+-+ +-+-+ + +-+-+-+ +-+-+ + + + + +-+ +-+-+ + +-+ + + +-+-+-+-+ +-+ + +-+ +-+ +-+ + + +-+-+-+ + +-+ +-+ +-+ +-+
| | | |         |     | |     |     | |       |   | |     |         | | |   | |         | | |           |   |   |     |   | |   |   |   |   |   |   | |
+ + + +-+ + +-+-+ +-+-+ +-+-+-+ +-+-+ + +-+-+-+ +-+ + +-+ +-+-+-+-+-+-+ + +-+ + +-+-+-+ + + +-+-+-+-+ +-+-+ +-+ +-+-+-+ +-+ +-+ + + + +-+ +-+ +-+ +-+ +
|   | |   |     |       |       |     | |       |   | |   |     |   |   |   | | |   | |   |   |     |   |   |   |     |   |   |   | | |     |   |     |
+-+ + + +-+-+-+ +-+-+-+-+ +-+-+-+ +-+-+ + +-+-+-+ +-+ + +-+ +-+ + + + +-+-+ + + +-+ + +-+-+-+ + +-+ +-+-+ +-+ +-+-+ +-+-+ +-+ +-+-+ + + +-+-+-+ + +-+-+
|   |   |     | |     |   |       | |   | | |     |   |       | | | |     |   |     |   |     | |   |     |       |     |   |       |   |   |   |     |
+ +-+-+-+-+ + + +-+-+ + +-+ +-+-+-+ + +-+ + + +-+-+ +-+-+-+-+ +-+ + + +-+-+-+-+-+-+-+-+ + +-+-+ + +-+-+ + + +-+-+ +-+-+ +-+ +-+-+-+-+-+-+ + +-+ +-+-+ +
|     |     | |   | | | | |   |   | | |   | |   |   |       |     |       |       |   | | |     |       | |   |       |   | |     |     | |   |     | |
+-+-+ + + +-+-+-+ + + + + +-+-+ + + + + +-+ +-+ + +-+-+-+-+ +-+-+-+-+-+-+ + +-+-+ +-+ + + + + +-+-+-+-+-+-+-+ + +-+-+-+-+ + + +-+ + +-+ + +-+ + +-+-+ +
|   |   | |     |     | |       |   | | |   | | |           |   |   |     | |     |   | |   | |       |     | | |       | | |   |   |   | |   | |   | |
+ +-+-+-+ + +-+ +-+ +-+ +-+-+ +-+-+ + + + +-+ + +-+-+-+-+ +-+ +-+ + + +-+-+-+ +-+-+ + + +-+-+ +-+-+-+ +-+-+ + + + +-+ +-+ + +-+ + +-+-+ + + +-+ + + + +
|         | |   | |   | |     |   | | |   |             |     |   | | |       |     | |   |   |       |     | |   |   |   |   | | |   |   | |   | |   |
+-+-+-+-+-+ + +-+ +-+ + + +-+-+ + + + +-+ + +-+ +-+-+-+-+-+-+ + +-+ + + +-+-+-+ +-+-+ + + + +-+ +-+-+-+ +-+ + +-+-+ +-+ + +-+ +-+ + + + +-+-+ + + +-+ +
|   | |     |       | |   |   | | | |   |   | |       |   |   | | | | |   |     |   |   |   |     |   | |   | |   |     |     |   | | |       | |   | |
+ + + + +-+-+-+ +-+-+ +-+-+ + + +-+ + + +-+-+ +-+-+-+-+ + + +-+ + + + +-+ + +-+-+-+ + +-+-+-+ +-+ + + + +-+-+ + + + +-+-+ +-+-+ +-+ + +-+-+-+-+-+-+ + +
| | |   |     |     |   | | |     | | | |       |       | |   | |   | |   | |       |   |   | |   | |   |     | | | |   | |   |   | |       |       | |
+ + + +-+ +-+ +-+-+ +-+ + + +-+-+ + +-+ + +-+-+ +-+ +-+-+ +-+ + +-+-+ + +-+ + + +-+-+-+-+ + + +-+-+ +-+-+ +-+-+ + + + + +-+ + +-+ +-+-+-+-+ + + +-+-+ +
| |   |   |   |   |     |   |     |   | | | |   |       |   | | |   | |   |   |   |       | |   |   |   |     | | |   |     |   |       | |   | |     |
+ +-+-+ +-+ +-+ + + +-+-+-+-+ +-+-+-+ + + + + +-+ +-+-+ + +-+ + +-+ + +-+ +-+-+-+-+ +-+-+-+ + + + +-+ + +-+ + + +-+ +-+-+-+-+ +-+-+-+-+ + +-+-+-+ +-+ +
| |   | |   |   | |     |   |   |   | |   |   |   |   | |     | |   |   | | |       |     |   | |     |     | |     |       |   |   | |           |   |
+ + + + + +-+ +-+ +-+-+ + + +-+ +-+ + +-+ + +-+ +-+ + + +-+-+-+ + + +-+ + + + +-+-+-+ +-+ +-+-+ +-+-+ + +-+-+ +-+-+-+ +-+-+ + + + + + +-+-+-+-+-+-+ +-+
|   |   |       |   | | | |   |   | |   | | |   |   | |   |   | | |   |   | |   |   |   | | |   |     | |   |   |   |   |   | | | | |               | |
+-+-+-+-+-+-+-+-+-+ + + + +-+-+-+ + +-+ +-+ + +-+-+-+ +-+ + +-+ +-+-+ +-+-+ +-+ + + +-+ + + + +-+ +-+-+-+ + +-+ + +-+-+ + +-+ + + + +-+-+-+-+-+-+ +-+ +
|       |     |     |   |   |   | |   |   | | |   |   |   |         | |   | |     |     | | |     |     | |       |     | | | |   |   |     |     |   |
+ + + +-+ +-+ + +-+-+-+-+-+ + + + +-+ + + + + + + + +-+ +-+ +-+ +-+ + +-+ + +-+-+-+-+-+-+ + + +-+-+ +-+ + +-+-+ + + +-+-+ + + +-+-+-+ + +-+ + +-+-+-+ +
| | |     | | |   |   |   |   | |   | | | | | | |   | | |   |   |   |     |         |     | | |     | |   |     | | |   | | | |     | |   |   |   |   |
+ + +-+-+-+ + +-+ +-+ +-+ +-+-+ +-+ + + +-+ + + +-+-+ + + +-+ +-+ +-+-+ +-+-+-+ +-+ + +-+-+ + + +-+-+ +-+-+ +-+-+ + + + + + + +-+ + + +-+-+-+-+-+ + +-+
| | |   |   |   |         |   | |     | |   | |   |   | |   | |       | |     |   | |       | |   |   |   |   |   | | | |   | |   | | |     |     |   |
+-+ + + + +-+-+ +-+-+-+ +-+-+ + + + +-+ + +-+ +-+ +-+ + +-+-+ + +-+-+-+ +-+ + +-+-+ +-+-+-+-+ +-+ + + + +-+-+ + +-+ + +-+-+ + + +-+ + + +-+ + +-+-+-+ +
|   | |   | |   |           |     |   | |   |   | |   |   |   |     |   |   | |     |     |   | |   | | |     |   | |   |   | |   | |   |   |   |     |
+ +-+ +-+-+ + +-+ +-+-+-+-+ +-+ +-+-+ + +-+ + + + + +-+ + + +-+-+-+ + +-+ +-+-+ +-+-+ +-+ + +-+ +-+-+-+ + +-+-+-+ + +-+ + +-+-+-+ +-+-+-+ +-+-+ + +-+-+
| |   |     |       |         | |   |   |     |   |     |   |   |   |   | |   | |     | |   |   |     |   |       | |   | |   |   |       |   | |   | |
+ + +-+ +-+-+-+-+-+-+ +-+-+-+-+ + + +-+-+ + +-+-+-+-+-+-+-+-+-+ + +-+-+ + +-+ + + +-+-+ +-+-+-+ + +-+ +-+-+ +-+-+-+ + +-+ + + +-+ + +-+-+-+-+ + + + + +
| |             |     |       | | |   |   |   |   |   |       |   |   | | |     | |     |     | |   |   |           | | |   |   |   |     |     | |   |
+ +-+-+-+-+-+-+ + +-+-+-+ + + + + +-+ + +-+ + + + +-+ + +-+-+ + +-+ + + + + +-+-+ + +-+-+ +-+ + +-+ +-+ +-+ +-+-+-+-+ + +-+-+-+ +-+-+ +-+ + + +-+ +-+-+
| |             |   |     | |   | | |   | | |   | |   |   |   |   | | | | |   |   |   |   |   |     | |   | |       | |     |   |   |   |   | |       |
+ + +-+-+-+-+-+-+-+ + +-+-+ +-+-+ + + +-+ + +-+-+ + +-+-+ + +-+-+ + + + + +-+ + +-+-+ + +-+ +-+-+-+-+ +-+ + + +-+-+ + +-+-+ + +-+ + + + +-+-+ + + +-+ +
|   |     |     |   | |   | |     | |   |   | |   | |     |       | |   | |   | |   | |   |     |   | |   | |     |       |       |   |     |   |   | |
+ +-+-+-+ + +-+ + +-+ +-+ + +-+-+ + +-+ + +-+ + +-+ + +-+-+-+-+-+-+ + +-+ + +-+ + + + +-+ +-+-+ + + + + +-+-+-+ + +-+-+-+ +-+-+-+-+-+-+-+-+ +-+-+-+-+ +
|         |   |           |         |   |     |     |               |         |   |       |     | |             |       |                   |
+-+-+-+-+-+-+-+-+-+-+-+-+-+-+-+-+-+-+-+-+-+-+-+-+-+-+-+-+-+-+-+-+-+-+-+-+-+-+-+-+-+-+-+-+-+-+-+-+-+-+-+-+-+-+-+-+-+-+-+-+-+-+-+-+-+-+-+-+-+-+-+-+-+-+-+
